WWWWWWWWWWW
W         W
W  W     WWWWWWWWWWWWWWWWWWW 
W                          W
WWWWWWW        W           W
W   WWW        W     W     W
W   WWW        W           W
W              WWWWW WWWWWWW
W       WW     W           W
W              W       W   W
WWWWWWWWWWWWWWWWWWWWWWWWWWWW
